. . . . . . . . . . . . . . . . . . . . . . . . . . . . . . . . . . . . . . . . . . . . . . . . . . . . .
. . . . . . . . . . . . . . . . . . . . . . . . . . . . . . . . . . . . . . . . . . . . . . . . . . . . . 
. . . . . . . . . . . . . . . . . . . . . . . . . . . . . . . . . . . . . . . . . . . . . . . . . . . . . 
. . . . . . . . 2 2 2 2 2 2 2 2 3 . . . . . . . . . . . . . . . . . 1 2 2 2 2 2 2 2 2 2 . . . . . . . . . 
. . . . . . . . 4 5 5 5 5 5 5 5 6 . . . . . . . . . . . . . . . . . 4 5 5 5 5 5 5 5 5 6 . . . . . . . . . 
. . . . . . . . 4 5 5 5 5 5 5 5 6 . . . . . . . . . . . . . . . . . 4 5 5 5 5 5 5 5 5 6 . . . . . . . . . 
. . . . . . . . 4 5 5 5 5 5 5 5 6 . . . . . . . . . . . . . . . . . 4 5 5 5 5 5 5 5 5 6 . . . . . C . . . 
. . . . . . . . 4 5 5 5 5 5 5 5 6 . . . . . . . . . . . . . . . . . 4 5 5 5 5 5 5 5 5 6 . . . . . . . . . 
. . . . . . . . 4 5 5 5 5 5 5 5 6 . . . . . . . . . . . . . . . . . 4 5 5 5 5 5 5 5 5 6 . . . . . . . . . 
. . . . . . . . 4 5 5 5 5 5 5 5 6 . Q . . . . . . C . . . . . . S . 4 5 5 5 5 5 5 5 5 6 . . . . . . . . . 
. . . . . . . . 4 5 5 5 5 5 5 5 5 2 2 3 . . . . . . . . . . . 1 2 2 5 5 5 5 5 5 5 5 5 6 . . . . . . . . . 
. . . . . . . . 4 5 5 5 5 5 5 5 5 5 5 5 3 . . . . P . . t . 1 5 5 5 5 5 5 5 5 5 5 5 5 6 . . . . . . . C . 
2 2 2 2 2 2 2 2 5 5 5 5 5 5 5 5 5 5 5 5 5 2 2 2 2 2 2 2 2 2 5 5 5 5 5 5 5 5 5 5 5 5 5 5 2 2 2 2 2 2 2 2 2 
5 5 5 5 5 5 5 5 5 5 5 5 5 5 5 5 5 5 5 5 5 5 5 5 5 5 5 5 5 5 5 5 5 5 5 5 5 5 5 5 5 5 5 5 5 5 5 5 5 5 5 5 5 
5 5 5 5 5 5 5 5 5 5 5 5 5 5 5 5 5 5 5 5 5 5 5 5 5 5 5 5 5 5 5 5 5 5 5 5 5 5 5 5 5 5 5 5 5 5 5 5 5 5 5 5 5 
5 5 5 5 5 5 5 5 5 5 5 5 5 5 5 5 5 5 5 5 5 5 5 5 5 5 5 5 5 5 5 5 5 5 5 5 5 5 5 5 5 5 5 5 5 5 5 5 5 5 5 5 5 
5 5 5 5 5 5 5 5 5 5 5 5 5 5 5 5 5 5 5 5 5 5 5 5 5 5 5 5 5 5 5 5 5 5 5 5 5 5 5 5 5 5 5 5 5 5 5 5 5 5 5 5 5 
5 5 5 5 5 5 5 5 5 5 5 5 5 5 5 5 5 5 5 5 5 5 5 5 5 5 5 5 5 5 5 5 5 5 5 5 5 5 5 5 5 5 5 5 5 5 5 5 5 5 5 5 5 
5 5 5 5 5 5 5 5 5 5 5 5 5 5 5 5 5 5 5 5 5 5 5 5 5 5 5 5 5 5 5 5 5 5 5 5 5 5 5 5 5 5 5 5 5 5 5 5 5 5 5 5 5