############### . . . . . . . . . . . . . . . . . . . . . . . . . . . . . . . . . . . . . . . . . . . . . . .
############### . . . . . . . . . . . . . . . . . . . . . . . . . . . . . . . . . . . . . . . . . . . . . . .
############### . . . . . . . . . . . . . . . . . . . . . . . . . . . . . . . . . . . . . . . . . . . . . . .
############### . . . . . . . . . . . . . . . . . . . . . . . . . . . . . . . . . . . . . . . . . . . . . . . 
############### . P . . . . . . . . . . . . . . . . . . . . . . . . . . . . . . . . . . . . . . . . . . . . . 
############### . . . . . . . . . . . . . . . . . . . . . . . . . . . . . . . . . . . . . . . . . . . . . . . 
############### . . . . . . . . . . . . . . . . . . . . . . . . . . . . . . . . . . . . . . . . . . . . . . .
############### . . . . . . . . . . . . . . . . . . . . . . . . . . . . . . . . . . . . . . . . . . . . . . .
############### . . . . . . . . . . . . . . . . . . # # # # # . . . . . . . . . . . . . . . . . . . . . . . .
############### . . . . . . . . . . . . . # # . . . . . . . . . . . . . . . . . . . . . . . . . . . . . . . .
############### . . . . . . . . . . . . # # # . . . . . . . . . . . . . . . . . . . . . . . . . . . . . . . .
############### . . . . . . . . . . . # # # # . . . . . . . . . # . . # . . . . . . . . . . . . . . . . . . .
############### # # # # # # # # # # # # # # # . . # # # # # # # # # # # # # # # . . # # # # # # # # # # # # #
############### # # # # # # # # # # # # # # # . . # # # # # # # # # # # # # # # . . # # # # # # # # # # # # #
############### # # # # # # # # # # # # # # # . . # # # # # # # # # # # # # # # . . # # # # # # # # # # # # #
############### # # # # # # # # # # # # # # # . . # # # # # # # # # # # # # # # . . # # # # # # # # # # # # #
############### # # # # # # # # # # # # # # # . . # # # # # # # # # # # # # # # . . # # # # # # # # # # # # #
############### # # # # # # # # # # # # # # # . . # # # # # # # # # # # # # # # . . # # # # # # # # # # # # #
