. . . . . . . . . . . . . . . . . . . . . . . . . . . . . . . . . . . . . . . . . . . . . . . . . . . . . . .
. . . . . . . . . . . . . . . . . . . . . . . . . . . . . . . . . . . . . . . . . . . . . . . . . . . . . . .
. . . . . . . . . . . . . . . . . . . . . . . . . . . . . . . . . . . . . . . . . . . . . . . . . . . . . . .
. . . . . . . . . . . . . . . . . . . . . . . . . . . . . . . . . . . . . . . . . . . . . . . . . . . . . . . 
. . . . . . . . . . . . . . . . . . . . . . . . . . . . . . . . . . . . . . . . . . . . . . . . . . . . . . . 
. . . . . . . . . . . . . . . . . . . . . . . . . . . . . . . . . . . . . . . . . . . . . . . . . . . . . . . 
############### . . . . . . . . . . . . . . . . . . . . . . . . . . . . . . . . . . . . . . . . . . . . . . .
############### . . . . . . . . . . . . . . . . . . . . . . . . . . . . . . . . . . . . . . . . . . . . . . .
############### . . . . . . . . . . . . . . . . . . # # # # # . . . . . . . . . . . . . . . . . . . . . . . .
############### . . . . . . . . . . . . . # # . . . . . . . . . . . . . . . . . . . . . . . . . . . . . . . .
############### . . . . . . . . . . . . # # # . . . . . . . . . . . . . . . . . . . . . . . . . . . . . . . .
############### P . . . . . . . . . . # # # # . . . . . . . . . # . . # . . . . . . . . . . . . . . . . . . .
############### # # # # # # # # # # # # # # # . . # # # # # # # # # # # # # # # . . # # # # # # # # # # # # #
############### # # # # # # # # # # # # # # # . . # # # # # # # # # # # # # # # . . # # # # # # # # # # # # #
############### # # # # # # # # # # # # # # # . . # # # # # # # # # # # # # # # . . # # # # # # # # # # # # #
############### # # # # # # # # # # # # # # # . . # # # # # # # # # # # # # # # . . # # # # # # # # # # # # #
############### # # # # # # # # # # # # # # # . . # # # # # # # # # # # # # # # . . # # # # # # # # # # # # #
############### # # # # # # # # # # # # # # # . . # # # # # # # # # # # # # # # . . # # # # # # # # # # # # #
