. . . . . . . . . . . . . . . . . . . . . . . . . . . . . . . . . . . . . . . . . . . . . . . .
. . . . . . . . . . . . . . . . . . . . . . . . . . . . . . . . . . . . . . . . . . . . . . . .
. . . . . . . . . . . . . . . . . . . . . . . . . . . . . . . . . . . . . . . . . . . . . . . .
. . . . . . . . . . . . . . . . . . . . . . . . . . . . . . . . . . . . . . . . . . . . . . . .
. . . . . . . . . . . . . . . . . . . . . . . . . . . . . . . . . . . . . . . . . . . . . . . .
. . . . . . . . . . . . . . . . . . . . . . . . . . . . . . . . . . . . . . . . . . . . . . . .
# . . . . . . . . . . . . . . . . . . . . . . . . . . . . . . . . . . . . . . . . . . . . . . .
# . . . . . . . . . . . . . . . . . . . . . . . . . . . . . . . . . . . . . . . . . . . . . . .
# . . . . . . . . . . . . . . . . . . # # # # # . . . . . . . . . . . . . . . . . . . . . . . .
# . . . . . . . . . . . . . # # . . . . . . . . . . . . . . . . . . . . . . . . . . . . . . . .
# . . . . . . . . . . . . # # # . . . . . . . . . . . . . . . . . . . . . . . . . . . . . . . .
# P . . . . . . . . . . # # # # . . . . . . . . . # . . # . . . . . . . . . . . . . . . . . . .
# # # # # # # # # # # # # # # # . . # # # # # # # # # # # # # # # . . # # # # # # # # # # # # #
# # # # # # # # # # # # # # # # . . # # # # # # # # # # # # # # # . . # # # # # # # # # # # # #
# # # # # # # # # # # # # # # # . . # # # # # # # # # # # # # # # . . # # # # # # # # # # # # #
# # # # # # # # # # # # # # # # . . # # # # # # # # # # # # # # # . . # # # # # # # # # # # # #
# # # # # # # # # # # # # # # # . . # # # # # # # # # # # # # # # . . # # # # # # # # # # # # #
# # # # # # # # # # # # # # # # . . # # # # # # # # # # # # # # # . . # # # # # # # # # # # # #
